0000000000000000000-
1111111111111111110-
0000000000000000010-
0000111111111111110-
0000100000000000000-
0000111111111000000-
0000000000001000000-
0000000011111000000-
0000000010000000000-
0000000011111111112-
0000000000000000000